
 ####     #   ####### ####### # ####
 #   #   # #     #       #    # #
 #   #   # #     #       #    # #
 ####   #   #    #       #    # ####
 #   #  #####    #       #    # #    
 #   # #     #   #       #    # #    
 ####  #     #   #       #    # ####
                                    
                                    
    ###  ####### #######  #     #   
   #   #    #       #     #     #   
   #        #       #      #   #    
   #        #       #       # #
   #        #       #   V    #
   #   #    #       #        #
    ###  #######    #        #
                  

               #####
               # ^ #
               #   #